XXXXXXXXX1XXXX2XXXXXXXXX
KKKKKKXOOOBBBBOOOXCCCCCC
KKKKKKOOBBBBBBBBOOCCCCCC
KKKKKKOOBBBBBBBBOOCCCCCC
KKKKKKOOBBBBBBBBOOCCCCCC
KKKKKKO@BBBBBBBB@O#CCCCX
XKKKKKOOBBBBBBBBOOOOOOO3
OOOO!OOOBBBBBBBBOOOOOOOX
XOOOOOOOO@OOOO@OOOPPPPPP
DDDDDOOOOOOOOOOOO%PPPPPP
DDDDDDDDOOAAAAAOOOPPPPPP
DDDDDDDDOOAAAAAOOOPPPPPP
DDDDDDDD$OAAAAAOOOPPPPPP
DDDDDDDDOOAAAAAOOOOO^O%X
DDDDDDDDOOAAAAAOOOLLLLLX
DDDDDDDDOOAAAAAOOLLLLLLL
XOOOOO$OOOAAAAAO^LLLLLLL
6OOOOOOOOOO**OOOOLLLLLLL
XOOOOO&OOHHHHHHOOOLLLLLX
GGGGGGGOOHHHHHHOOOOOOOO4
GGGGGGGOOHHHHHH*O(OOOOOX
GGGGGGGOOHHHHHHOOSSSSSSS
GGGGGGGOOHHHHHHOOSSSSSSS
GGGGGGGOOHHHHHHOOSSSSSSS
GGGGGGX5XXHHHHXXOXSSSSSS
