XXXXXXXXXX1XXXX2XXXXXXXXXX
XKKKKKKXOOOBBBBOOOXCCCCCCX
XKKKKKKOOBBBBBBBBOOCCCCCCX
XKKKKKKOOBBBBBBBBOOCCCCCCX
XKKKKKKOOBBBBBBBBOOCCCCCCX
XKKKKKKObBBBBBBBBbOcCCCCXX
XXKKKKKOOBBBBBBBBOOOOOOO3X
XOOOOkOOOBBBBBBBBOOOOOOOXX
XXOOOOOOOObOOOObOOOPPPPPPX
XDDDDDOOOOOOOOOOOOpPPPPPPX
XDDDDDDDDOOAAAAAOOOPPPPPPX
XDDDDDDDDOOAAAAAOOOPPPPPPX
XDDDDDDDDdOAAAAAOOOPPPPPPX
XDDDDDDDDOOAAAAAOOOOOlOpXX
XDDDDDDDDOOAAAAAOOOLLLLLXX
XDDDDDDDDOOAAAAAOOLLLLLLLX
XXOOOOOdOOOAAAAAOlLLLLLLLX
X6OOOOOOOOOOhhOOOOLLLLLLLX
XXOOOOOgOOHHHHHHOOOLLLLLXX
XGGGGGGGOOHHHHHHOOOOOOOO4X
XGGGGGGGOOHHHHHHhOsOOOOOXX
XGGGGGGGOOHHHHHHOOSSSSSSSX
XGGGGGGGOOHHHHHHOOSSSSSSSX
XGGGGGGGOOHHHHHHOOSSSSSSSX
XGGGGGGX5XXHHHHXXOXSSSSSSX
XXXXXXXXXXXXXXXXXXXXXXXXXX

