XXXXXXXXXX1XXXX2XXXXXXXXXX
XKKKKKKXOOOBBBBOOOXCCCCCCX
XKKKKKKOOBBBBBBBBOOCCCCCCX
XKKKKKKOOBBBBBBBBOOCCCCCCX
XKKKKKKOOBBBBBBBBOOCCCCCCX
XKKKKKKObBBBBBBBBbOcCCCCXX
XXKKKKKOOBBBBBBBBOOOOOOO3X
XOOOOkOOOBBBBBBBBOOOOOOOXX
XXOOOOOOOObOOOObOOOPPPPPPX
XDDDDDDDDOOOOOOOOOpPPPPPPX
XDDDDDDDDOOOAAAAOOOPPPPPPX
XDDDDDDDDOOOAAAAOOOPPPPPPX
XDDDDDDDDdOOAAAAOOOPPPPPPX
XDDDDDDDDOOOAAAAOOOOOlOpXX
XDDDDDDDDOOOAAAAOOOLLLLLXX
XDDDDDDDDOOOAAAAOOOLLLLLLX
XXOOOOOdOOOOOOOOOOlLLLLLLX
X6OOOOOOOOOOhhOOOOOLLLLLLX
XXOOOOOgOOHHHHHHOOOLLLLLXX
XGGGGGGGOOHHHHHHOOOOOOOO4X
XGGGGGGGOhHHHHHHhOsOOOOOXX
XGGGGGGGOOHHHHHHOOSSSSSSSX
XGGGGGGGOOHHHHHHOOSSSSSSSX
XGGGGGGGOOHHHHHHOOSSSSSSSX
XGGGGGGX5XXHHHHXXOXSSSSSSX
XXXXXXXXXXXXXXXXXXXXXXXXXX

