XXXXXXXXX1XXXX2XXXXXXXXXX
KKKKKKXOOOBBBBOOOXCCCCCCX
KKKKKKOOBBBBBBBBOOCCCCCCX
KKKKKKOOBBBBBBBBOOCCCCCCX
KKKKKKOOBBBBBBBBOOCCCCCCX
KKKKKKObBBBBBBBBbOcCCCCXX
XKKKKKOOBBBBBBBBOOOOOOO3X
OOOOkOOOBBBBBBBBOOOOOOOXX
XOOOOOOOObOOOObOOOPPPPPPX
DDDDDOOOOOOOOOOOOpPPPPPPX
DDDDDDDDOOAAAAAOOOPPPPPPX
DDDDDDDDOOAAAAAOOOPPPPPPX
DDDDDDDDdOAAAAAOOOPPPPPPX
DDDDDDDDOOAAAAAOOOOOlOpXX
DDDDDDDDOOAAAAAOOOLLLLLXX
DDDDDDDDOOAAAAAOOLLLLLLLX
XOOOOOdOOOAAAAAOlLLLLLLLX
6OOOOOOOOOOhhOOOOLLLLLLLX
XOOOOOgOOHHHHHHOOOLLLLLXX
GGGGGGGOOHHHHHHOOOOOOOO4X
GGGGGGGOOHHHHHHhOsOOOOOXX
GGGGGGGOOHHHHHHOOSSSSSSSX
GGGGGGGOOHHHHHHOOSSSSSSSX
GGGGGGGOOHHHHHHOOSSSSSSSX
GGGGGGX5XXHHHHXXOXSSSSSSX

