XXXXXXXX1XXXXXXXXXXXXXXXXX
XKKKKKKXOBBBBBBBBb2CCCCCCX
XKKKKKKOOBBBBBBBBOOCCCCCCX
XKKKKKKOOBBBBBBBBOOCCCCCCX
XKKKKKKObBBBBBBBBOOCCCCCCX
XKKKKKKOOBBBBBBBBOOcCCCCXX
XXKKKKKObBBBBBBBBOOOOOOO3X
XOOOOkOOOBBBBBBBBbOOOOOOXX
XXOOOOOOObOObOObOOOPPPPPPX
XDDDDDDDDOOOOOOOOOpPPPPPPX
XDDDDDDDDOOOAAAAOOOPPPPPPX
XDDDDDDDDOOOAAAAOOOPPPPPPX
XDDDDDDDDdOOAAAAOOOPPPPPPX
XDDDDDDDDOOOAAAAOOOOOlOpXX
XDDDDDDDDOOOAAAAOOOLLLLLXX
XDDDDDDDDOOOAAAAOOOLLLLLLX
XXOOOOOdOOOOOOOOOOlLLLLLLX
X6OOOOOOOOOOhhOOOOOLLLLLLX
XXOOOOOgOOHHHHHHOOOLLLLLXX
XGGGGGGGOOHHHHHHOOOOOOOO4X
XGGGGGGGOhHHHHHHhOsOOOOOXX
XGGGGGGGOOHHHHHHOOSSSSSSSX
XGGGGGGGOOHHHHHHOOSSSSSSSX
XGGGGGGGOOHHHHHHOOSSSSSSSX
XGGGGGGX5XHHHHHHXOXSSSSSSX
XXXXXXXXXXXXXXXXXXXXXXXXXX

