XXXXXXXXXXXXXXXXXXXXXXXXXX
XOOOXXXOOAAAAAAAAOOOOOOOOX
XOOXOOOXOAAAAAAAAOXXXXXXOX
XOXOOOOOOAAAAAAAAOOOXXOOOX
XOXOOOOOOAAAAAAAAOOOXXOOOX
XOXOOOOOOAAAAAAAAOOOXXOOOX
XOOXOOOXOAAAAAAAAOOOXXOOOX
XOOOXXXOOAAAAAAAAbOOOOOOOX
XXOOOOOOOOOOOOOOOOPPPPPPPX
XDDDDDDDOOOOOOOOOpPPPPPPPX
XDDDDDDDdOOOOOOOOOPPPPPPPX
XDDDDDDDOO6XXXX5OOPPPPPPPX
XSSSSSSSOOOOOOOOOOKKKKKKKX
XSSSSSSSsO4XXXX2OkKKKKKKKX
XSSSSSSSOOOOOOOOOOKKKKKKKX
XGGGGGGGGO1XXXX3OLLLLLLLLX
XGGGGGGGGgOOOOOOlLLLLLLLLX
XGGGGGGGGOOOOOOOOLLLLLLLLX
XGGGGGGGGOOOOOOOOLLLLLLLLX
XBBBBBBBOOOOOOOOOOCCCCCCCX
XBBBBBBBbOOOhhOOOcCCCCCCCX
XBBBBBBBOOHHHHHHOOCCCCCCCX
XBBBBBBBOOHHHHHHOOCCCCCCCX
XBBBBBBBOOHHHHHHOOCCCCCCCX
XBBBBBBBOOHHHHHHOOCCCCCCCX
XXXXXXXXXXXXXXXXXXXXXXXXXX

