XXXXXXXXX1XXXX2XXXXXXXXX
KKKKKKXOOOBBBBOOOXCCCCCC
KKKKKKOOBBBBBBBBOOCCCCCC
KKKKKKOOBBBBBBBBOOCCCCCC
KKKKKKOOBBBBBBBBOOCCCCCC
KKKKKKObBBBBBBBBbOcCCCCX
XKKKKKOOBBBBBBBBOOOOOOO3
OOOOkOOOBBBBBBBBOOOOOOOX
XOOOOOOOObOOOObOOOPPPPPP
DDDDDOOOOOOOOOOOOpPPPPPP
DDDDDDDDOOAAAAAOOOPPPPPP
DDDDDDDDOOAAAAAOOOPPPPPP
DDDDDDDDdOAAAAAOOOPPPPPP
DDDDDDDDOOAAAAAOOOOOlOpX
DDDDDDDDOOAAAAAOOOLLLLLX
DDDDDDDDOOAAAAAOOLLLLLLL
XOOOOOdOOOAAAAAOlLLLLLLL
6OOOOOOOOOOhhOOOOLLLLLLL
XOOOOOgOOHHHHHHOOOLLLLLX
GGGGGGGOOHHHHHHOOOOOOOO4
GGGGGGGOOHHHHHHhOsOOOOOX
GGGGGGGOOHHHHHHOOSSSSSSS
GGGGGGGOOHHHHHHOOSSSSSSS
GGGGGGGOOHHHHHHOOSSSSSSS
GGGGGGX5XXHHHHXXOXSSSSSS
